9,28
----------------------------
-**************************-
-*--*---*----o-----*---*--*-
-*-***--************--***-*-
-***-****----------****-***-
-*-***--*****s******--***-*-
-*--*---*----------*---*--*-
-**************************-
----------------------------