----------------------------
-**************************-
-*--*---*----d-----*---*--*-
-*-***--************--***-*-
-***-****----------****-***-
-*-***--*****s******--***-*-
-*--*---*----------*---*--*-
-**************************-
----------------------------