----------------------------
-**************************-
-*--*---*----d-----*---*--*-
-*-*-*--************--*-*-*-
-***-****----------****-***-
-*-*-*--*****s******--*-*-*-
-*--*---*----------*---*--*-
-**************************-
----------------------------